# Map file for tile-based game
# (Lines that start with '#' are comments)
# The tiles are:
#   (Space) Empty tile
#   A..Z    Tiles A through Z
#   o       Star
#   !       Music Note
#   *       Goal
#   1       Bad Guy 1 (grub)
#   2       Bad Guy 2 (fly)
#   ^       Mushroom
#	E		Exploding
#	G		Gas
#	W		Water Top
#	U		Underwater
                                                                                                                                                                                                        A
                                                                                                                                      AA                                                                A
                                                                                                                                      AA                                                                A
                                                                                                                                      AA                                                                A
            o  1                      o                                o  1    AAAA            1      1                               AA                                                                A
                                                 ^        ^                    AAAA                                                   AA                                                                A
ABABABEBABABABABABABAGABABABABABABABABABABABABABABABABABABABABABABABABABABABABAAAAABABABABEABABABABABABGABABAAFFFFFFFFFFFFFFFFFFFFFFFFAAFFFFFFFFFFFFFFFFFFFFFFFFFFFFFFFFFAABABABABABABABABABABABABABABABA
AAAAAAAAAAAAAAAAAAAAAAAAAAAAAAAAAAAAAAAAAAAAAAAAAAAAAAAAAAAAAAAAAAAAAAAAAAAAAAAAAAAAAAAAAAAAAAAAAAAAAAAAAAAAAAAAAAAAAAAAAAAAAAAAAAAAAAAAAAAAAAAAAAAAAAAAAAAAAAAAAAAAAAAAAAAAAAAAAAAAAAAAAAAAAAAAAAAAAAAAA
